v,v,v,v,v,v,v,v,v,v,v,v,v,v,v,v,v,v,v,v
v,v,v,v,v,v,_,_,_,_,_,_,_,_,_,v,v,v,v,v
v,v,v,v,v,_,_,_,_,_,_,_,_,_,_,_,v,v,v,v
v,v,v,v,_,_,_,v,v,v,v,v,v,_,_,_,_,v,v,v
v,v,v,_,_,_,v,v,v,₩,₩,₩,v,v,_,_,_,v,v,v
_,_,_,_,_,_,v,₩,₩,₩,₩,₩,₩,v,v,_,_,_,v,v
_,_,_,_,_,_,v,₩,₩,₩,₩,₩,₩,₩,v,v,_,_,v,v
v,v,v,_,_,_,v,₩,₩,₩,₩,₩,₩,₩,v,v,_,_,v,v
v,v,v,v,_,_,v,v,₩,₩,₩,₩,₩,₩,v,v,_,_,v,v
v,v,v,v,_,_,v,v,v,v,₩,₩,₩,v,v,_,_,_,v,v
v,v,v,v,_,_,_,v,v,v,v,v,v,v,_,_,_,v,v,v
v,v,v,v,_,_,_,v,v,v,v,v,v,v,_,_,_,v,v,v
v,v,v,v,v,_,_,_,_,v,v,v,v,_,_,_,_,v,v,v
v,v,v,v,v,_,_,_,_,_,_,_,_,_,_,_,v,v,v,v
v,v,v,v,v,v,_,_,_,_,_,_,_,_,_,v,v,v,v,v
v,v,v,v,v,v,v,v,v,_,_,_,_,v,v,v,v,v,v,v
v,v,v,v,v,v,v,v,v,v,_,_,v,v,v,v,v,v,v,v
v,v,v,v,v,v,v,v,v,v,_,_,v,v,v,v,v,v,v,v
v,v,v,v,v,v,v,v,v,v,_,_,v,v,v,v,v,v,v,v
v,v,v,v,v,v,v,v,v,v,_,_,v,v,v,v,v,v,v,v